0 0 0 0 0 0 0 0 40 41 40 0 0 22 23 24
0 0 0 0 0 0 0 0 42 43 41 0 0 62 63 64
0 0 0 0 0 0 0 0 0 40 40 0 0 102 103 104
0 0 0 0 0 0 0 0 0 40 41 0 0 142 143 144
0 0 0 0 0 0 0 0 0 41 40 0 0 182 183 184
0 0 0 0 0 0 0 0 0 41 40 0 0 222 223 224
0 0 0 0 0 0 0 0 0 40 40 40 0 0 0 0
0 0 0 0 0 0 0 0 0 0 41 40 40 0 0 0
0 0 0 0 0 0 0 0 0 0 0 42 40 40 0 0
0 0 0 0 0 0 0 0 0 0 0 0 43 40 40 42
0 0 0 0 0 0 0 0 0 0 0 0 0 0 40 40
0 0 0 0 0 0 0 0 0 0 0 0 0 0 0 0